░░░░░░░░░░░░░░░░░░░░░
░█████████░█████████░
░█░░░░░░░░░░░░░░░░░█░
░█░░███░░█░█░░███░░█░
░█░█░░░█░█░█░█░░░█░█░
░█░█░█░█░█░█░█░█░█░█░
░█░█░█░█░█░█░█░█░█░█░
░█░█░█░█░█░█░█░█░█░█░
░█░█░█░█░█░█░█░█░█░█░
░█░█░█░█░█░█░█░█░█░█░
░█░█░█░█░█░█░█░█░█░█░
░█░█░█░█░█░█░█░█░█░█░
░█░█░░░█░█░█░█░░░█░█░
░░░░░░░░░░░░░░░░░░░░░
░████████░P░████████░
░█░░░░░░░░░░░░░░░░░█░
░█░██░██░█░█░██░██░█░
░█░█░░░█░█░█░█░░░█░█░
░█░░░█░░░█░█░░░█░░░█░
░█████████░█████████░
░░░░░░░░░░░░░░░░░░░░░